David De-Gea	Goalie
Lee Grant	Goalie
Sergio Romero	Goalie
Dean Henderson	Goalie
Nathan Bishop	Goalie
Max Taylor	Defender
Victor Lindelof	Defender
Eric Bailly	Defender
Phil Jones	Defender
Harry Maguire	Defender
Marcos Rojo	Defender
Luke Shaw	Defender
Alex Telles	Defender
Aaron Wan-Bissaka	Defender
Brandon Williams	Defender
Axel Tuanzebe	Defender
Paul Pogba	Mid-Fielder
Juan Mata	Mid-Fielder
Fred Fred	Mid-Fielder
Bruno Fernandes	Mid-Fielder
Daniel James	Mid-Fielder
Nemanja Matic	Mid-Fielder
Donny van-de-Beek	Mid-Fielder
Scott McTominay	Mid-Fielder
Arnau Puigmal-Martinez	Mid-Fielder
Ethan Galbraith	Mid-Fielder
Edinson Cavani	Forward
Anthony Martial	Forward
Marcus Rashford	Forward
Mason Greenwood	Forward
D'Mani Bughail-MellorÂ 	Forward
Anthony Elanga	Forward
Shola Shoretire	Forward
Amad Traore	Forward
